************************
*@                     *
*          *           *
*        ********      *
* **                   *
*      *        ****** *
*      *               *
*      ********        *
*   *                  *
*   *      *           *
************************